,OMA Sum rate,Architecture Sum rate,Baseline Sum rate,Fixed NOMA Sum rate,Fixed NOMA Pairs,NOMA Pairs,Baseline NOMA Pairs,Fixed NOMA Outage
0,223.77984703473817,359.2176376410548,365.8227712278226,243.62228701332674,3,13,14,11
1,223.77984703473817,359.2176376410548,365.8227712278226,243.62228701332674,3,13,14,11
2,202.86210600604394,365.41810535424264,371.0668872783274,217.8653799360635,2,13,13,11
3,191.11156274808906,340.9960839004781,345.47897185019536,242.9360346548083,4,15,15,11
4,202.03231205198108,350.86393744082847,356.99967624101026,231.3044656411458,3,12,13,10
5,196.90094475324727,347.4581902765839,347.4581902765839,213.99163128817588,3,13,13,10
6,190.9747600831962,285.499371004111,285.499371004111,224.13358224575666,1,10,10,9
7,196.12294728456038,303.1488884206858,305.2112388480872,257.05299155071174,3,12,12,9
8,209.4639445421308,365.0432259615578,367.0102349650016,227.73298064555374,2,13,13,11
9,178.6701780048998,328.9936203189318,328.9936203189318,246.17441770992295,4,12,12,8
10,173.09240768297337,344.0776391087936,346.1410977892783,182.08955258799713,3,13,13,10
11,227.5376819489467,347.04649829843527,350.7700169058711,245.55384470935567,2,13,14,12
12,185.0262471401938,315.07519813145075,317.86892206311154,229.49876956755037,4,14,13,9
13,233.61279380654116,337.35042222294686,342.64129512666926,292.3687082223739,3,12,13,10
14,200.01531154744424,334.038881191208,334.8645465779109,220.92503945816568,3,14,14,11
15,182.62325495233557,282.2171790487571,282.21717904875703,212.41312995184163,3,9,9,6
16,220.61214893039443,313.3458097576017,313.3458097576017,293.03385518151026,3,11,11,8
17,210.92707462786464,346.8542341914756,347.60487894290463,210.9270746278646,0,12,13,13
18,227.5899672719152,335.25131936723415,336.2127076840196,233.00436274986257,1,11,11,10
19,186.15524589290996,357.1807861947252,365.2943935267324,297.9105767543296,7,14,14,7
20,292.4646892261935,372.95851970458233,372.95851970458233,355.8546673364287,3,10,10,7
21,234.46894740536317,363.08590719544253,363.08590719544253,330.83048883529636,3,11,11,8
22,229.67184099677337,328.13251696768975,328.13251696768975,261.5659868540894,4,10,10,6
23,185.99489914031824,287.5856577703069,287.5856577703069,211.16162469948844,1,10,10,9
24,185.7358950795844,321.9897477746433,322.35847104610355,192.69980930358233,2,14,13,11
25,239.0299877968041,366.8638710818071,370.7850036320775,298.5013556322172,4,13,13,9
26,188.99964329985792,298.21943657744174,299.39634318402875,270.456788696994,3,11,11,8
27,167.72666849294413,342.756721465924,344.63523682729834,227.5725603569515,5,16,16,11
28,218.3123027833172,363.81384949489706,363.81384949489706,236.18614879945952,1,13,13,12
29,229.86995802973877,346.07258012404185,346.10661402070525,353.0093859023043,4,13,13,9
30,219.9153011510009,379.96740171662464,385.3633065383806,219.91530115100088,0,13,13,13
31,223.89741694582318,297.7342349359137,297.7342349359137,223.89741694582318,0,9,9,9
32,175.06991365725028,344.1782135504912,344.1782135504912,204.4796249588441,3,14,14,11
33,162.7385230282896,315.40195528465085,329.96081298354306,224.40951309876246,4,16,16,12
34,169.7504689183997,324.4976483569533,325.5819604313256,327.34995986529634,8,13,13,5
35,248.15768286628875,358.7037958209693,358.7037958209693,315.8056840112431,2,10,10,8
36,201.48814568100306,350.4110708205492,350.46612800872884,264.4571657174577,4,11,11,7
37,236.0402226116336,319.09531814565787,319.09531814565787,236.0402226116336,0,9,9,9
38,236.0402226116336,319.09531814565787,319.09531814565787,236.0402226116336,0,9,9,9
39,236.0402226116336,319.09531814565787,319.09531814565787,236.0402226116336,0,9,9,9
40,228.05660622415297,337.1877258823139,337.1877258823139,243.5571377810067,1,9,9,8
41,194.51837613679737,340.9649502212109,340.9649502212109,228.34076658573716,3,12,12,9
42,226.31471138473623,335.2321109097843,335.2321109097843,276.90308141813466,3,10,10,7
43,206.807637455342,363.7223489431302,363.7223489431302,239.216489613014,3,12,12,9
44,205.69781131238423,318.83966043124474,319.18841140161186,257.2809953080194,3,12,13,10
45,205.69781131238423,318.83966043124474,319.18841140161186,257.2809953080194,3,12,13,10
46,230.1465245212634,345.73314134512043,345.73314134512043,254.4889973674657,3,10,10,7
47,209.71044812901053,311.9828847461894,313.10113934342905,228.20052417505528,2,11,11,9
48,209.71044812901053,311.9828847461894,313.10113934342905,228.20052417505528,2,11,11,9
49,230.53539206641037,343.4872191958724,343.4872191958724,237.68187133996983,1,10,10,9
50,220.2115953872319,298.3865430877004,298.3865430877004,251.62980789082192,2,11,11,9
51,194.2593289749711,344.3248757823676,344.8702130713036,254.4269635419746,4,14,15,11
52,201.59840648586763,320.67313635988717,324.34022422604403,217.80500402975315,3,12,13,10
53,227.56948858373372,346.28303732936,348.43946239716905,243.01677461397057,3,13,13,10
54,227.56948858373372,346.28303732936,348.43946239716905,243.01677461397057,3,13,13,10
55,249.68657281403267,342.7906461149073,344.1581488378517,256.29014735435936,3,10,10,7
56,197.62989083458547,293.7777255920211,293.7777255920211,265.26184348808977,3,10,10,7
57,197.62989083458547,293.7777255920211,293.7777255920211,265.26184348808977,3,10,10,7
58,174.50188910144723,341.5101315830698,342.309217225526,237.78936249684276,6,13,14,8
59,219.17934581010013,325.60402867674196,326.5501034957104,232.95032590452018,1,11,12,11
60,217.38019340888835,305.22260693604284,305.63434045993915,225.53820477643097,2,8,8,6
61,158.87505193951242,321.12246908480273,322.9551082167507,181.24620372358234,3,14,14,11
62,187.73958592369235,341.8550915811096,342.68956094464875,214.50827318205705,4,13,12,8
63,187.73958592369235,341.8550915811096,342.68956094464875,214.50827318205705,4,13,12,8
64,182.10554640386334,319.1176704828942,319.1176704828942,266.627232035298,4,13,13,9
65,195.56771551112854,323.667913313697,324.20116994043445,253.2615975065283,4,13,13,9
66,195.56771551112854,323.667913313697,324.20116994043445,253.2615975065283,4,13,13,9
67,195.56771551112854,323.667913313697,324.20116994043445,253.2615975065283,4,13,13,9
68,195.7926755451727,340.47642110355366,340.47642110355366,239.86626385753922,2,13,13,11
69,195.7926755451727,340.47642110355366,340.47642110355366,239.86626385753922,2,13,13,11
70,174.30225366480005,308.4675876550061,310.4675876550061,223.547529311001,4,14,14,10
71,174.30225366480005,308.4675876550061,310.4675876550061,223.547529311001,4,14,14,10
72,259.49927888596744,302.1517966257252,302.1517966257252,274.55580115995656,2,8,8,6
73,259.49927888596744,302.1517966257252,302.1517966257252,274.55580115995656,2,8,8,6
74,236.08249226468482,296.89429034174435,296.89429034174435,250.48274373132702,2,6,6,4
75,236.08249226468482,296.89429034174435,296.89429034174435,250.48274373132702,2,6,6,4
76,236.08249226468482,296.89429034174435,296.89429034174435,250.48274373132702,2,6,6,4
77,239.78706210692582,365.63355960581936,368.19510760904257,278.0282822200981,4,11,11,7
78,229.1269686953437,335.44593196801225,336.6090486321813,295.7967402447638,3,11,12,9
79,153.40414455875367,336.5562991801331,337.79654345657275,261.5937143818286,6,16,15,9
80,153.40414455875367,336.5562991801331,337.79654345657275,261.5937143818286,6,16,15,9
81,153.40414455875367,336.5562991801331,337.79654345657275,261.5937143818286,6,16,15,9
82,206.26521982334225,281.59404126402745,281.59404126402745,250.78838011880728,2,10,10,8
83,206.26521982334225,281.59404126402745,281.59404126402745,250.78838011880728,2,10,10,8
84,206.26521982334225,281.59404126402745,281.59404126402745,250.78838011880728,2,10,10,8
85,240.44512320603135,296.88805258219725,296.88805258219725,240.44512320603138,0,6,6,6
86,240.44512320603135,296.88805258219725,296.88805258219725,240.44512320603138,0,6,6,6
87,240.44512320603135,296.88805258219725,296.88805258219725,240.44512320603138,0,6,6,6
88,207.64464700139675,319.273507071434,319.273507071434,275.53743360800377,3,10,10,7
89,207.64464700139675,319.273507071434,319.273507071434,275.53743360800377,3,10,10,7
90,207.64464700139675,319.273507071434,319.273507071434,275.53743360800377,3,10,10,7
91,207.64464700139675,319.273507071434,319.273507071434,275.53743360800377,3,10,10,7
92,207.64464700139675,319.273507071434,319.273507071434,275.53743360800377,3,10,10,7
93,207.64464700139675,319.273507071434,319.273507071434,275.53743360800377,3,10,10,7
94,186.09157704317178,323.8918450668057,338.26078925920865,283.5946120656685,4,14,15,11
95,188.07081031959802,331.98955294276493,334.4102156303701,205.39854138389703,2,14,14,12
96,188.07081031959802,331.98955294276493,334.4102156303701,205.39854138389703,2,14,14,12
97,188.07081031959802,331.98955294276493,334.4102156303701,205.39854138389703,2,14,14,12
98,188.07081031959802,331.98955294276493,334.4102156303701,205.39854138389703,2,14,14,12
99,179.93789808609188,318.2800849428493,319.5269922814764,257.2140177900553,6,13,13,7
100,227.47924447410622,367.2377398560785,367.2377398560785,335.9079522950623,4,11,11,7
101,227.47924447410622,367.2377398560785,367.2377398560785,335.9079522950623,4,11,11,7
102,227.47924447410622,367.2377398560785,367.2377398560785,335.9079522950623,4,11,11,7
103,202.21383552045427,347.81230360580025,349.8724579433165,205.2138293544716,1,13,13,12
104,209.5258483656806,360.0634951845477,360.497539497228,218.16504003420698,3,11,11,8
105,209.5258483656806,360.0634951845477,360.497539497228,218.16504003420698,3,11,11,8
106,209.5258483656806,360.0634951845477,360.497539497228,218.16504003420698,3,11,11,8
107,192.89367900756815,318.1539416815791,320.19053611845845,237.84115640464177,3,12,12,9
108,222.95257305848196,323.07508627495014,323.25841912512175,222.38740070820623,1,11,12,11
109,222.95257305848196,323.07508627495014,323.25841912512175,222.38740070820623,1,11,12,11
110,222.95257305848196,323.07508627495014,323.25841912512175,222.38740070820623,1,11,12,11
111,222.95257305848196,323.07508627495014,323.25841912512175,222.38740070820623,1,11,12,11
112,227.21069037552792,336.99999979338565,338.2664596111851,307.82394620524315,4,10,10,6
113,227.21069037552792,336.99999979338565,338.2664596111851,307.82394620524315,4,10,10,6
114,227.21069037552792,336.99999979338565,338.2664596111851,307.82394620524315,4,10,10,6
115,227.21069037552792,336.99999979338565,338.2664596111851,307.82394620524315,4,10,10,6
116,188.9555170845604,334.76679136851305,334.76679136851305,249.99656651689224,5,14,14,9
117,188.9555170845604,334.76679136851305,334.76679136851305,249.99656651689224,5,14,14,9
118,197.0223351910434,296.35366120410293,296.35366120410293,219.25447100840555,2,13,13,11
119,204.51968038622675,353.0482254554805,354.26414931310177,354.0959393120454,4,12,12,8
120,204.51968038622675,353.0482254554805,354.26414931310177,354.0959393120454,4,12,12,8
121,193.0876414313584,335.78259517114685,336.80311847882655,254.23713642853457,6,11,13,7
122,144.54146989418194,312.9149275105521,314.0355948641151,231.32883331960812,7,14,14,7
123,144.54146989418194,312.9149275105521,314.0355948641151,231.32883331960812,7,14,14,7
124,202.79531595012514,357.3138737436121,361.48396654285676,223.2805238293814,2,14,14,12
125,215.82396572464188,364.57553386802545,368.54068103326927,249.3985578267869,1,14,14,13
126,215.82396572464188,364.57553386802545,368.54068103326927,249.3985578267869,1,14,14,13
127,193.91680814179443,319.88712922285913,319.88712922285913,246.36894546149975,4,11,11,7
128,245.90389850153366,349.4642721551392,350.35195255113445,262.52621367405436,2,10,11,9
129,245.90389850153366,349.4642721551392,350.35195255113445,262.52621367405436,2,10,11,9
130,189.7513846731964,319.53744689753137,323.75514503765544,280.40292056130875,4,12,13,9
131,238.74170201188576,339.4717014064254,339.4717014064254,297.8867918048247,3,9,9,6
132,238.74170201188576,339.4717014064254,339.4717014064254,297.8867918048247,3,9,9,6
133,195.94841974301983,329.94585355762183,330.71620196535935,246.8349325214983,4,12,13,9
134,252.1540336783862,335.83329608337084,335.83329608337084,266.7044082229347,1,10,10,9
135,252.1540336783862,335.83329608337084,335.83329608337084,266.7044082229347,1,10,10,9
136,176.74529819847572,355.23839711293544,358.83451353500305,324.1205498245869,6,14,14,8
137,216.34028230181605,320.8192953108644,320.8192953108644,273.57329774532127,3,11,11,8
138,216.34028230181605,320.8192953108644,320.8192953108644,273.57329774532127,3,11,11,8
139,158.12654102910085,296.55471274591207,297.3055554962648,239.07460083947805,4,12,11,7
140,161.83059923169617,286.60763707330716,287.88501586465,214.41849826859647,5,13,13,8
141,161.83059923169617,286.60763707330716,287.88501586465,214.41849826859647,5,13,13,8
142,161.83059923169617,286.60763707330716,287.88501586465,214.41849826859647,5,13,13,8
143,191.67825058420397,325.0707224646967,331.57435706306717,334.31649947828623,5,13,14,9
144,198.07540090250032,338.9480084049735,341.57585031718423,284.7107378989373,5,13,13,8
145,198.07540090250032,338.9480084049735,341.57585031718423,284.7107378989373,5,13,13,8
146,247.40175063293256,352.85244119115634,352.85244119115634,267.1481702093793,2,10,10,8
147,255.68641640483077,359.4394657501133,359.4394657501133,255.68641640483077,0,11,11,11
148,255.68641640483077,359.4394657501133,359.4394657501133,255.68641640483077,0,11,11,11
149,255.68641640483077,359.4394657501133,359.4394657501133,255.68641640483077,0,11,11,11
0,217.10693231548123,300.8581564214614,301.79719948731884,243.54023801992648,3,9,10,7
1,214.76397232348387,316.2465132565039,316.2465132565039,214.76397232348387,0,12,12,12
2,180.8930299602485,300.68783292457624,300.68783292457624,230.97142990029494,2,11,11,9
3,222.37651036176405,330.2695259400146,330.2695259400146,237.74458790568082,2,9,9,7
4,211.59078816405554,340.65330109252136,340.65330109252136,246.277275822783,2,11,11,9
5,172.4631677309764,320.4237668781932,320.57539039807284,242.30217472712755,5,13,13,8
6,229.14808868174123,320.7268933702229,320.7268933702229,248.82346098614886,1,8,8,7
7,209.56299724053252,282.6368496892975,284.4290972093388,215.95978840587193,2,10,12,10
8,210.70613732608987,322.4463347624767,326.16607548680827,256.91369903319685,2,13,13,11
9,198.55715081802052,338.27956756516267,339.3692887802529,306.1836173833717,4,13,13,9
10,217.9373957586186,350.20057552699535,353.2646238468004,255.09931776853225,2,12,12,10
11,240.48792669256795,329.22339426196606,329.22339426196606,272.18135345886503,2,8,8,6
12,180.3129969658748,277.145132828001,277.14513282800095,183.28983170270064,1,10,10,9
13,222.16171427959273,304.63725646330647,304.89297044921244,261.3232205452519,2,10,10,8
14,260.379157554832,320.78918840057696,320.78918840057696,260.379157554832,0,6,6,6
15,232.90072760505225,333.7679686825103,333.7679686825103,238.62550001710835,3,10,10,7
16,225.8386938369544,338.2991805352881,340.1736726367701,319.50794481227706,5,12,12,7
17,216.50390062406711,342.73678692087253,345.1907180239168,290.4269300286989,4,12,12,8
18,191.1373102013264,349.3083226587663,349.3083226587663,253.733156600366,3,13,13,10
19,227.2752165549563,335.5135156339276,336.94496039699453,247.50314843663153,5,11,12,7
20,240.10185751504935,334.58032192146095,335.4709552200985,247.38002407958098,2,10,10,8
21,154.82807499486165,337.2717159178232,340.54308319910695,253.77910019284886,7,14,15,8
22,232.80363488789487,305.4053553683351,305.4053553683351,302.02860550731924,2,8,8,6
23,200.0637192082246,321.55727900499414,321.56785591613095,249.95534055520335,5,12,11,6
24,190.6062510907617,303.9785005038808,303.9785005038808,219.85653408826303,3,10,10,7
25,247.3641233632276,349.5660998186281,349.5660998186281,262.12696181130525,2,9,9,7
26,174.57277626085175,338.58194312284445,338.7704545289684,195.10122444470133,2,16,15,13
27,228.5854055785647,376.12663199981506,376.12663199981506,242.86040044764997,1,11,11,10
28,202.46135246282128,313.9937643193264,313.9937643193264,213.65643441235403,3,10,10,7
29,224.8751574057443,354.82587351676926,354.82587351676926,252.26265517141178,1,8,8,7
30,238.26810007144073,331.34656398515176,331.34656398515176,240.8128825131109,1,11,11,10
31,238.26810007144073,331.34656398515176,331.34656398515176,240.8128825131109,1,11,11,10
32,204.33993878333456,321.22289742856424,322.1585031299229,258.89299632986854,3,12,13,10
33,188.81584065494283,285.8431360877844,285.8431360877844,266.09751270337625,3,9,9,6
34,203.88805160567904,328.33427546545767,328.33427546545767,206.87160790547094,1,13,13,12
35,189.03724160209305,304.0061251086167,304.00612510861674,244.47109528829372,3,9,9,6
36,172.63721161692501,311.4601549406964,311.4601549406964,262.6869422657954,3,11,11,8
37,226.82534262845513,330.12268520512055,332.9806004635703,232.31894279905507,3,12,12,9
38,174.9998165734514,328.6793952260675,333.638115217316,201.06594561570753,4,11,13,9
39,227.05655660867473,342.1442593909301,342.1442593909301,250.74947915309127,2,12,12,10
40,167.47766389851412,317.92317068191653,324.03135876251724,218.1315389234178,6,13,14,8
41,239.861328219914,348.8768659257709,349.31972678147577,293.2112184082125,5,12,12,7
42,145.0854729889819,315.60491947024434,315.60491947024434,271.31367065445914,6,11,11,5
43,207.44795286926376,284.0567180112814,284.0567180112814,207.4479528692637,0,8,8,8
44,207.5888188077621,361.6556343915378,361.6556343915378,207.58881880776207,0,11,11,11
45,207.5888188077621,361.6556343915378,361.6556343915378,207.58881880776207,0,11,11,11
46,182.24461036140212,317.26445373804506,317.26445373804506,341.36299243489503,7,13,13,6
47,182.24461036140212,317.26445373804506,317.26445373804506,341.36299243489503,7,13,13,6
48,182.24461036140212,317.26445373804506,317.26445373804506,341.36299243489503,7,13,13,6
49,182.24461036140212,317.26445373804506,317.26445373804506,341.36299243489503,7,13,13,6
50,199.76628812183355,296.97769013974516,296.97769013974516,207.41785783775853,2,12,12,10
51,236.7445229292469,325.4492843302154,325.4492843302154,239.60299264797462,1,10,10,9
52,236.7445229292469,325.4492843302154,325.4492843302154,239.60299264797462,1,10,10,9
53,210.47084741464545,312.2699836384566,312.2699836384566,265.81420885226277,4,11,11,7
54,206.14921969345102,342.0409524756559,342.8653266079201,275.25302798059437,3,12,12,9
55,178.8493458113569,342.06764274833955,350.69784282041195,201.82794776929558,3,14,14,11
56,178.8493458113569,342.06764274833955,350.69784282041195,201.82794776929558,3,14,14,11
57,178.8493458113569,342.06764274833955,350.69784282041195,201.82794776929558,3,14,14,11
58,222.40375910425004,335.9494277484099,335.9494277484099,264.83224251374725,4,12,12,8
59,222.40375910425004,335.9494277484099,335.9494277484099,264.83224251374725,4,12,12,8
60,248.71230537423915,354.46515393392343,354.46515393392343,339.6139752128183,5,12,12,7
61,248.71230537423915,354.46515393392343,354.46515393392343,339.6139752128183,5,12,12,7
62,248.71230537423915,354.46515393392343,354.46515393392343,339.6139752128183,5,12,12,7
63,248.71230537423915,354.46515393392343,354.46515393392343,339.6139752128183,5,12,12,7
64,223.18844642243124,312.7517976402182,312.7517976402182,277.64820129438476,3,8,8,5
65,223.18844642243124,312.7517976402182,312.7517976402182,277.64820129438476,3,8,8,5
66,223.18844642243124,312.7517976402182,312.7517976402182,277.64820129438476,3,8,8,5
67,223.18844642243124,312.7517976402182,312.7517976402182,277.64820129438476,3,8,8,5
68,223.18844642243124,312.7517976402182,312.7517976402182,277.64820129438476,3,8,8,5
69,194.03413619694018,331.6463005495768,331.6463005495768,194.03413619694012,0,14,14,14
70,194.03413619694018,331.6463005495768,331.6463005495768,194.03413619694012,0,14,14,14
71,194.03413619694018,331.6463005495768,331.6463005495768,194.03413619694012,0,14,14,14
72,194.03413619694018,331.6463005495768,331.6463005495768,194.03413619694012,0,14,14,14
73,194.03413619694018,331.6463005495768,331.6463005495768,194.03413619694012,0,14,14,14
74,228.75941634987458,308.4326368861317,308.4326368861317,250.70092035472683,2,9,9,7
75,228.75941634987458,308.4326368861317,308.4326368861317,250.70092035472683,2,9,9,7
76,179.8193953964894,350.5088765674452,353.78020122882515,222.72576541277923,4,15,15,11
77,179.8193953964894,350.5088765674452,353.78020122882515,222.72576541277923,4,15,15,11
78,179.8193953964894,350.5088765674452,353.78020122882515,222.72576541277923,4,15,15,11
79,179.8193953964894,350.5088765674452,353.78020122882515,222.72576541277923,4,15,15,11
80,234.02218766486698,329.45630318609824,331.38373421762566,237.5723018027711,1,10,10,9
81,234.02218766486698,329.45630318609824,331.38373421762566,237.5723018027711,1,10,10,9
82,233.28833810012358,347.03959615582994,347.62549610424173,267.8133513756067,2,13,13,11
83,147.28596199994638,263.2851383922289,263.2851383922289,223.1652948632104,3,10,10,7
84,147.28596199994638,263.2851383922289,263.2851383922289,223.1652948632104,3,10,10,7
85,215.68145393989664,331.2159611798262,331.2159611798262,238.2614902772785,4,8,8,4
86,215.68145393989664,331.2159611798262,331.2159611798262,238.2614902772785,4,8,8,4
87,215.68145393989664,331.2159611798262,331.2159611798262,238.2614902772785,4,8,8,4
88,233.47232774856337,331.3664190188648,331.36641901886486,248.48874248729481,2,8,8,6
89,233.47232774856337,331.3664190188648,331.36641901886486,248.48874248729481,2,8,8,6
90,205.115121591275,332.83561993991736,332.83561993991736,241.36000189838896,3,12,12,9
91,205.115121591275,332.83561993991736,332.83561993991736,241.36000189838896,3,12,12,9
92,205.115121591275,332.83561993991736,332.83561993991736,241.36000189838896,3,12,12,9
93,210.4404837364149,338.30421205449215,339.7547797196987,213.0185758554325,1,8,9,8
94,225.90322726538085,286.1282020595616,286.1282020595616,259.2321042994162,2,7,7,5
95,225.90322726538085,286.1282020595616,286.1282020595616,259.2321042994162,2,7,7,5
96,225.90322726538085,286.1282020595616,286.1282020595616,259.2321042994162,2,7,7,5
97,227.6986251173943,350.54486896400937,351.5081779319929,227.6986251173943,0,12,12,12
98,195.61243223401294,318.61159169085784,320.3403176131088,197.08216034336576,2,12,11,9
99,195.61243223401294,318.61159169085784,320.3403176131088,197.08216034336576,2,12,11,9
100,195.61243223401294,318.61159169085784,320.3403176131088,197.08216034336576,2,12,11,9
101,168.93981843967674,324.277479023754,324.277479023754,184.7168938569308,3,13,13,10
102,202.31052609773712,316.9307010704989,316.9307010704989,233.30965414549914,1,10,10,9
103,202.31052609773712,316.9307010704989,316.9307010704989,233.30965414549914,1,10,10,9
104,202.31052609773712,316.9307010704989,316.9307010704989,233.30965414549914,1,10,10,9
105,206.49326168895607,313.24857800618605,313.24857800618605,220.56438160027943,3,8,8,5
106,194.47345691576703,305.1115616622706,305.1115616622706,207.41726381281978,3,11,11,8
107,194.47345691576703,305.1115616622706,305.1115616622706,207.41726381281978,3,11,11,8
108,218.5969752078703,317.02929356865513,317.02929356865513,228.47160737634653,3,11,11,8
109,163.88440684618882,303.63478712359097,306.4435406859178,194.6452249843874,3,14,14,11
110,163.88440684618882,303.63478712359097,306.4435406859178,194.6452249843874,3,14,14,11
111,162.00157629272286,331.59722413001066,331.59722413001066,228.88539643729996,4,12,12,8
112,226.96574013997443,317.6186544189444,317.6186544189444,229.05645557759553,2,7,7,5
113,226.96574013997443,317.6186544189444,317.6186544189444,229.05645557759553,2,7,7,5
114,156.42040910965466,316.50686273057534,316.50686273057534,193.08984446707314,2,12,12,10
115,180.7009344187236,339.16782873232137,339.16782873232137,290.6749178598219,5,12,12,7
116,180.7009344187236,339.16782873232137,339.16782873232137,290.6749178598219,5,12,12,7
117,228.52447785054093,348.9480802314846,350.51818788550975,296.37964803304635,4,13,13,9
118,207.78452538080992,337.049503591915,337.049503591915,225.15272337998007,3,10,10,7
119,207.78452538080992,337.049503591915,337.049503591915,225.15272337998007,3,10,10,7
120,212.93353907515515,323.62023670062905,323.62023670062905,307.1190632228847,3,12,12,9
121,193.93254083313946,312.7117669553261,315.0870471165956,252.4528143387949,4,12,12,8
122,193.93254083313946,312.7117669553261,315.0870471165956,252.4528143387949,4,12,12,8
123,227.0529690468134,297.90922623315527,298.6383664004909,257.7815593605185,1,10,10,9
124,217.66546637324632,336.17899521395583,340.118269827346,246.04940229145737,2,11,12,10
125,217.66546637324632,336.17899521395583,340.118269827346,246.04940229145737,2,11,12,10
126,194.05590908314542,332.8237794845456,335.3185878216961,218.08868093565107,3,13,13,10
127,213.10095714571315,363.78756810743147,364.94616921095115,260.70797791581634,3,12,13,10
128,213.10095714571315,363.78756810743147,364.94616921095115,260.70797791581634,3,12,13,10
129,172.91004407140565,276.65509549498137,276.65509549498137,209.1667448389895,3,11,11,8
130,169.26965358496034,251.16870592091212,251.16870592091212,176.2696210644956,1,9,9,8
131,169.26965358496034,251.16870592091212,251.16870592091212,176.2696210644956,1,9,9,8
132,140.14566966021445,303.72133553137957,304.20323919764667,190.95935655683962,3,12,13,10
133,205.2491965759114,334.43477596381877,334.60928460383104,266.9052470901982,2,8,9,7
134,205.2491965759114,334.43477596381877,334.60928460383104,266.9052470901982,2,8,9,7
135,184.93631671295168,305.7848084963864,305.7848084963864,220.7780134281341,2,13,13,11
136,214.32939189103035,300.31534233051286,300.31534233051286,243.77879615576703,3,6,6,3
137,214.32939189103035,300.31534233051286,300.31534233051286,243.77879615576703,3,6,6,3
138,214.32939189103035,300.31534233051286,300.31534233051286,243.77879615576703,3,6,6,3
139,228.5215888192733,308.4481654177645,309.18834541051353,271.5729675841707,5,10,10,5
140,228.5215888192733,308.4481654177645,309.18834541051353,271.5729675841707,5,10,10,5
141,228.5215888192733,308.4481654177645,309.18834541051353,271.5729675841707,5,10,10,5
142,238.39955019437778,320.90799621106635,320.90799621106635,298.7310721050418,2,10,10,8
143,191.95497901530666,312.4265647881117,312.4265647881117,227.29264484584152,4,10,10,6
144,191.95497901530666,312.4265647881117,312.4265647881117,227.29264484584152,4,10,10,6
145,204.41676468328276,351.5982843681152,352.75316222448185,274.28135614030975,6,11,12,6
146,204.41676468328276,351.5982843681152,352.75316222448185,274.28135614030975,6,11,12,6
147,204.41676468328276,351.5982843681152,352.75316222448185,274.28135614030975,6,11,12,6
148,204.41676468328276,351.5982843681152,352.75316222448185,274.28135614030975,6,11,12,6
149,206.4651430330976,293.1862810347691,293.1862810347691,244.13982952732053,3,9,9,6
0,138.37218579170298,314.75942059747695,315.7175532889128,214.94894853089633,4,15,15,11
1,144.2643906113855,316.9427838730255,325.6773238731082,260.52468186702384,5,16,17,12
2,266.240210066158,386.92072298870016,395.33191265683166,389.76397176809945,5,12,13,8
3,263.29905927458856,417.5244542509348,420.6319310593053,298.40374600709083,3,13,14,11
4,240.01236024590187,363.0336858758171,363.0336858758172,242.62856557803445,1,10,10,9
5,267.58939620373735,412.91632570779234,414.5383452295423,267.58939620373735,0,13,12,12
6,215.88326703509114,391.21976088444995,405.6753219516708,245.82870819329625,2,14,15,13
7,246.3146408785334,416.0658322991148,417.2982376453821,318.5374190150313,4,13,13,9
8,264.6150695276349,402.9545210126387,405.99533165281355,368.2091254622269,3,11,12,9
9,227.1362070957221,339.51303761455006,341.2219380514659,402.1505754879302,5,12,12,7
10,223.82118163590144,332.08424245015425,334.94949683132637,229.92395153743405,1,15,13,12
11,237.58320026805868,363.31396969535217,367.43558259642305,312.3780081095553,5,12,13,8
12,236.9947209441709,356.3210122145513,356.3210122145513,257.88413739411396,2,10,10,8
13,233.6219193173734,398.4902874304636,401.2320051585454,270.3636823372467,2,13,14,12
14,243.54244730879793,371.6647666869362,374.2020658608381,436.7886224119084,6,10,10,4
15,193.5343821382344,362.29209839536446,369.6668904139589,252.0022280349592,3,13,14,11
16,197.92330058422993,350.5679587881167,362.8313498587024,289.9627096462178,6,15,15,9
17,246.1338889609523,394.3309076896295,397.0064203071908,314.8135342037713,3,10,11,8
18,194.5911239461848,335.12839691572447,336.83925415466945,342.66671282273836,6,12,12,6
19,202.017805292253,382.64568404820034,388.71948987213875,276.7523238078485,4,14,15,11
20,214.05106513442433,377.995108212765,379.15167021157,252.9089089071383,5,11,12,7
21,198.10502880798782,378.55936856368373,385.05349358309354,220.74970075084056,2,14,14,12
22,290.78001529796416,402.22897780997914,406.5978722239089,353.534027735841,4,12,13,9
23,202.37699688309445,350.59624685752783,358.76346576759465,241.76249704794108,4,14,14,10
24,249.71789629551594,400.90149209068295,416.0245364714425,303.6522245250529,3,14,14,11
25,275.4923807355931,414.28664362156803,415.97805378143045,353.0469367712454,5,12,13,8
26,198.30946498408267,381.21524682706695,385.35630961768845,284.8731552479117,3,15,15,12
27,226.96244455680093,404.972010796959,408.2962349364542,275.76860292676855,2,13,14,12
28,254.68319987984404,429.10124945660993,430.10124945660993,268.38073526902156,1,13,13,12
29,254.68319987984404,429.10124945660993,430.10124945660993,268.38073526902156,1,13,13,12
30,240.9176822750864,380.716082581305,381.904861422402,283.7762044026049,4,12,12,8
31,304.30998726657583,418.6806681733451,419.95925366570793,318.4668149234201,3,9,9,6
32,244.39871492483897,385.5482474576745,389.33963367182224,261.14732161825964,2,14,14,12
33,227.13426466921572,391.1313893962269,393.24246232168935,276.48248167409827,2,13,13,11
34,227.19390285572922,379.1054793762007,380.4345851779458,289.55811720495205,5,13,13,8
35,235.30100462019632,392.89302284086466,394.2816216170226,286.136475732464,4,11,10,6
36,208.18954671002786,348.35516748977136,348.35516748977136,263.2405780219426,3,11,11,8
37,201.58651505221425,370.44695823051467,373.17021906740206,309.6282021162883,4,14,15,11
38,275.0912993788942,384.3163009856429,385.72922740888384,331.164261332608,4,11,10,6
39,221.7346247617179,349.26515827016726,352.10688249366734,245.66518838734788,4,13,14,10
40,221.7346247617179,349.26515827016726,352.10688249366734,245.66518838734788,4,13,14,10
41,226.57470221000403,351.03295550468454,351.94568941662635,343.40552819662133,6,11,11,5
42,249.890682638809,403.0566073879287,407.29757168848823,257.5631387205569,2,13,14,12
43,217.6848932549045,406.3204709977083,421.99246749002776,245.9713433267766,3,13,14,11
44,223.65089081041404,368.2824350450332,368.9080354857772,238.1775056840071,2,11,12,10
45,223.65089081041404,368.2824350450332,368.9080354857772,238.1775056840071,2,11,12,10
46,153.4013000184961,355.0113889749762,371.49447533624414,203.74562724204034,5,15,16,11
47,247.43749663361183,402.1091310857785,408.0895156883762,339.3792411539896,4,14,15,11
48,263.2721389172051,393.527873315626,395.47720778090564,301.0728071550069,2,10,10,8
49,241.68596736668633,369.34002233278477,369.34002233278477,333.0032151939898,3,11,11,8
50,191.98131441412676,376.61582885367295,378.5982744053605,212.42948448764247,4,13,13,9
51,191.98131441412676,376.61582885367295,378.5982744053605,212.42948448764247,4,13,13,9
52,240.29105906233548,399.0691566693366,402.7371964985334,304.9535509451722,3,12,14,11
53,248.7774278997947,368.4793045593464,369.9971520445938,302.3755775060032,3,12,12,9
54,248.7774278997947,368.4793045593464,369.9971520445938,302.3755775060032,3,12,12,9
55,248.7774278997947,368.4793045593464,369.9971520445938,302.3755775060032,3,12,12,9
56,248.7774278997947,368.4793045593464,369.9971520445938,302.3755775060032,3,12,12,9
57,253.59776638631317,394.41744835783305,395.84981391978425,317.38160691748635,2,12,11,9
58,195.78130126106086,348.722970895341,349.8554438678509,239.1094391256275,5,15,15,10
59,195.78130126106086,348.722970895341,349.8554438678509,239.1094391256275,5,15,15,10
60,195.78130126106086,348.722970895341,349.8554438678509,239.1094391256275,5,15,15,10
61,246.43090621299845,373.2671565508633,375.7288000706928,268.08039824007176,2,9,10,8
62,228.96491193454327,385.33134922981674,403.6494827796208,274.8659069014415,3,14,14,11
63,228.96491193454327,385.33134922981674,403.6494827796208,274.8659069014415,3,14,14,11
64,245.26451477689523,401.9833940729716,401.9833940729716,281.27557115220293,1,11,11,10
65,245.26451477689523,401.9833940729716,401.9833940729716,281.27557115220293,1,11,11,10
66,245.26451477689523,401.9833940729716,401.9833940729716,281.27557115220293,1,11,11,10
67,245.26451477689523,401.9833940729716,401.9833940729716,281.27557115220293,1,11,11,10
68,204.168827546648,384.7495275144461,398.68425719188986,298.996281367606,6,16,16,10
69,204.168827546648,384.7495275144461,398.68425719188986,298.996281367606,6,16,16,10
70,202.09015634374336,372.77750754140015,378.8766480624813,253.01472392810362,3,12,13,10
71,202.09015634374336,372.77750754140015,378.8766480624813,253.01472392810362,3,12,13,10
72,202.09015634374336,372.77750754140015,378.8766480624813,253.01472392810362,3,12,13,10
73,202.09015634374336,372.77750754140015,378.8766480624813,253.01472392810362,3,12,13,10
74,242.18273373251165,349.18272809446273,351.3168058520563,284.0712384694805,4,12,11,7
75,283.59848822411607,361.228400124514,362.2340666469423,336.90636194049637,2,12,11,9
76,283.59848822411607,361.228400124514,362.2340666469423,336.90636194049637,2,12,11,9
77,283.59848822411607,361.228400124514,362.2340666469423,336.90636194049637,2,12,11,9
78,283.59848822411607,361.228400124514,362.2340666469423,336.90636194049637,2,12,11,9
0,283.59848822411607,361.228400124514,362.2340666469423,336.90636194049637,2,12,11,9
1,231.62344671296273,374.15025545982076,375.5767947848707,266.7019677287354,2,9,9,7
2,129.7160010384061,326.0238235461153,327.893375174877,150.3031233134403,2,17,17,15
3,248.78297400039264,368.25446387981435,370.25446387981435,297.8011941963753,4,12,12,8
4,198.87482108486986,336.60190993814996,336.60190993814996,231.82793573704433,2,12,12,10
5,232.15528027991715,316.1598368720478,317.14325122223727,238.1356311151862,1,9,10,9
6,207.00681401224253,339.01029116651216,339.01029116651216,216.1122947520142,3,11,11,8
7,189.90088531464878,353.2489097079446,353.2489097079446,287.6996647849761,6,14,14,8
8,212.30067153866025,305.1521822021962,305.5185687952255,260.41250801812987,3,13,13,10
9,188.98949539923353,320.52249462427136,321.82764937708106,230.7940969264611,3,12,13,10
10,216.47573749059393,305.65754502578295,305.65754502578295,229.3822550302576,3,10,10,7
11,157.82903551428836,304.2314759950708,305.2314759950708,174.00809089857813,2,12,12,10
12,226.11586736128942,360.23377674181944,360.23377674181944,298.9008989552375,4,12,12,8
13,207.55894490787446,330.6736296529713,331.94276038511543,294.39923197236095,8,12,12,4
14,179.35522304593673,354.92685211972645,361.29387655073253,244.8556042572424,6,15,14,8
15,223.3078118028244,327.9521569742034,327.9521569742034,238.12902003845508,1,12,12,11
16,214.90002571469344,337.87195683282357,337.87195683282357,225.26293091372446,2,11,11,9
17,162.823810106584,317.57751460671307,318.77667831237835,228.41944123431344,5,12,12,7
18,173.0825877868112,363.9970164719317,363.9970164719317,246.47737171541436,7,13,13,6
19,159.34405349743707,308.1041048143792,309.0577293836424,205.3604703274272,3,14,14,11
20,192.1535166289183,311.26220155096985,311.26220155096985,197.9101976746471,2,12,12,10
21,237.00771631400892,359.5263318993568,366.7403766972464,251.44745306198615,2,13,13,11
22,232.37012340552712,331.3466597232318,331.3466597232318,263.2087530463393,2,10,10,8
23,196.97267499559547,350.3833402103031,351.86343867813036,296.7346282815217,4,13,14,10
24,189.51622021009786,342.8590384248504,342.8590384248504,261.15563195155073,4,11,11,7
25,207.04956664081257,326.77783563711614,328.7179910143134,256.13222973209196,4,10,11,7
26,247.23030325401635,319.07807858242006,320.310640410064,308.43740229062337,2,8,8,6
27,195.27304181519503,336.58943447509574,336.58943447509574,272.87112979435244,4,12,12,8
28,250.09574629026014,347.0061122393954,350.3420394607492,359.74348846595905,4,11,10,6
29,195.20632958609255,311.8174657639353,312.83354292141763,238.10818360388893,3,11,12,9
30,237.49648270853035,362.7099096366135,369.7428851779575,306.13369257590995,4,12,13,9
31,171.7196530712787,330.893530978041,337.820517989014,223.78415716242282,4,14,15,11
32,225.71205000453367,372.2747580437871,378.0015038312456,247.56736150025284,2,13,14,12
33,210.34986084939993,317.5340350113261,317.5340350113261,250.38900023319124,2,7,7,5
34,210.34986084939993,317.5340350113261,317.5340350113261,250.38900023319124,2,7,7,5
35,202.5454997303516,298.9837054021311,298.9837054021311,254.09298969368697,3,10,10,7
36,223.38902618021808,332.714871006875,332.714871006875,280.6311510357908,4,9,9,5
37,207.30669331121982,308.14087710759145,308.14087710759145,237.2739220845152,1,11,11,10
38,199.4606687992255,349.7475539716287,351.6581399262884,253.22407925580384,4,13,13,9
39,233.7258574014003,328.5534830153583,329.42920773999606,265.6945415391229,3,12,11,8
40,229.51508110432107,306.16968874943126,306.16968874943126,229.51508110432107,0,8,8,8
41,228.6977477429212,297.85832235034354,297.85832235034354,228.69774774292122,0,7,7,7
42,223.62601859431635,358.4161201212722,362.7858887034203,315.1336895749759,5,14,14,9
43,189.03438509856943,320.6946535208486,324.8433411630114,210.58945685181263,3,11,12,9
44,228.56517515590951,352.44302526715455,352.44302526715455,325.4151485791983,5,10,10,5
45,206.7309542876103,370.4808359935096,371.3767311006351,244.576862320516,5,12,12,7
46,167.54061827936363,299.20989262430857,300.47412331675855,187.8997787276664,4,15,15,11
47,194.4524376923136,329.8677658288221,335.7262115470336,250.97988009218807,5,15,14,9
48,130.34747965478957,283.0994059485946,287.68531084816635,156.38697785518048,2,15,15,13
49,174.50444374336612,277.54337362930596,279.75248906384024,223.69431466608327,2,10,11,9
50,195.7421271398697,313.80618171893093,313.80618171893093,264.6091935430448,3,11,11,8
51,228.75505786019744,341.2573293269305,343.273593841379,258.7047352440559,1,13,12,11
52,256.6499116562256,375.1998949005571,375.1998949005571,256.6499116562256,0,8,8,8
53,223.64295075497884,306.56374860994947,306.56374860994947,299.3195445672977,3,10,10,7
54,204.9659383006896,317.29297886700385,317.29297886700385,280.26987183732575,4,11,11,7
55,198.39102653437754,349.0570409128508,351.0962194185406,207.4188396024801,1,14,13,12
56,170.9148538256297,330.3746109217396,333.533960873764,251.236569508686,6,12,12,6
57,214.27721040152048,360.70530137499753,360.70530137499753,246.80879584146658,2,12,12,10
58,169.16139173327673,340.72086836256324,340.72086836256324,207.987718744804,3,13,13,10
59,168.75288689709606,322.9871219882423,322.9871219882423,182.2977169669241,1,15,15,14
60,147.07237366590925,293.32140452003216,293.32140452003216,170.8357424833335,4,14,14,10
61,189.11167552819416,299.38491113875403,299.38491113875403,210.21238310508758,2,12,12,10
62,156.04085440598413,320.9356945618146,320.9356945618146,280.94023138483686,6,13,13,7
63,280.42336120033207,371.2582409809752,372.44042463373546,287.44620149572256,1,10,10,9
64,174.00109530977764,324.16697305517766,324.16697305517766,218.39093815902373,1,13,13,12
65,236.69906660783084,320.61628757855664,320.61628757855664,251.50871923681484,1,9,9,8
66,207.26524552063296,344.98927015761006,354.86916989855206,221.20139044646749,1,13,14,13
67,166.54477326641643,345.9380042385913,351.0480667930638,222.48118793533422,5,16,16,11
68,192.94789583294312,321.3446613647049,321.3446613647049,268.4917489128123,3,12,12,9
69,192.94789583294312,321.3446613647049,321.3446613647049,268.4917489128123,3,12,12,9
70,177.27478064481247,333.43855978731494,333.43855978731494,184.08551024494068,1,13,13,12
71,215.90917842924335,329.85221595693224,329.85221595693224,234.63843657338919,2,12,12,10
72,199.18187265844963,324.66209469338776,327.970690996098,277.68327491316944,3,13,13,10
73,199.18187265844963,324.66209469338776,327.970690996098,277.68327491316944,3,13,13,10
74,288.27712381215065,377.8259182573662,377.8259182573662,334.21764910935536,2,9,9,7
75,165.29430398036538,322.1587212211981,324.7612714047026,255.66137308512256,5,13,13,8
76,202.23920709798273,299.359640127648,299.359640127648,208.651106595995,1,11,11,10
77,202.23920709798273,299.359640127648,299.359640127648,208.651106595995,1,11,11,10
78,206.85801798142757,357.4177120935884,357.4177120935884,264.5396888384057,4,12,12,8
79,206.85801798142757,357.4177120935884,357.4177120935884,264.5396888384057,4,12,12,8
80,183.55704126986194,358.6041168851334,361.1059463414082,297.8709241669646,6,13,13,7
81,210.94069265540475,317.0775622534977,319.97896604988335,260.0543996552744,2,12,12,10
82,217.5707409517279,339.13397129754,339.13397129754,280.5176353399775,2,11,11,9
83,208.43438175202806,329.43490197936035,329.9069774141865,212.2420745745597,2,12,11,9
84,209.3569015920124,304.83207517694257,306.0296242159021,261.7056786199946,3,10,11,8
85,156.16109394459843,292.50427076001574,298.25396108814294,307.69142154976726,7,14,14,7
86,200.83377629498605,356.5283430553862,358.5283430553862,234.3375241578053,3,14,14,11
87,220.80246440802028,343.7068225780699,345.58960270195723,297.3160781021595,2,12,11,9
88,249.16454771238963,368.3791190071952,369.51360145038313,291.47365089246745,2,10,10,8
89,231.29354399284657,353.7403526249435,353.7403526249435,233.0336294566109,1,10,10,9
90,224.634816062429,328.4439535824696,328.4439535824696,231.27371562327303,1,8,8,7
91,211.89284497946983,324.01720804740455,325.01720804740455,255.0387647855601,4,11,11,7
92,211.89284497946983,324.01720804740455,325.01720804740455,255.0387647855601,4,11,11,7
93,158.12733166707977,302.95261220078373,302.95261220078373,282.364563443444,5,11,11,6
94,216.14322821460433,355.35314939887223,355.35314939887223,264.48454695313734,4,12,12,8
95,209.8122197167486,340.95694095650896,340.95694095650896,216.73011700539882,1,11,11,10
96,202.17155588837383,356.1319440685837,361.22446747444747,257.322827210769,5,13,13,8
97,240.70373488540685,363.0347945302877,365.533744467909,285.1625238169169,4,11,11,7
98,235.62922882009408,368.3753990477836,368.3753990477836,301.64561805039006,2,11,11,9
99,262.9713034751628,365.9156616368473,365.9156616368473,279.46516567675735,2,7,7,5
100,211.43476188210718,340.2373077815732,344.4281390028609,254.45274633189365,3,12,11,8
101,212.34507469806482,356.7620304375526,358.12031053132034,272.6167943726368,3,12,12,9
103,170.4601878040531,332.3949133634585,332.3949133634585,272.6217051369616,4,12,12,8
104,189.66795158786135,345.49905521783626,345.49905521783626,293.303480942845,6,12,12,6
105,189.66795158786135,345.49905521783626,345.49905521783626,293.303480942845,6,12,12,6
106,159.62156955327714,319.62321546103794,319.62321546103794,173.98601252750285,2,15,15,13
107,200.16495740118788,307.3021803687674,307.33499197157266,299.01700287534715,4,12,12,8
108,185.84469033017015,301.94044146551556,301.94044146551556,186.8001521636985,1,11,11,10
109,185.84469033017015,301.94044146551556,301.94044146551556,186.8001521636985,1,11,11,10
110,207.32609693522238,344.05857228782224,344.05857228782224,222.37456353333067,3,11,11,8
111,189.7002053975619,351.26749760150875,352.6026342939422,266.56663810171955,4,13,13,9
112,189.7002053975619,351.26749760150875,352.6026342939422,266.56663810171955,4,13,13,9
113,222.2906844586768,325.17529643309035,325.17529643309035,250.8812815893,5,9,9,4
114,181.60293883353137,340.69838837343394,340.85662453459554,255.1178967602292,4,12,13,9
115,181.60293883353137,340.69838837343394,340.85662453459554,255.1178967602292,4,12,13,9
116,209.1783374944169,324.243567479082,327.7448641902414,250.99245298849564,4,11,10,6
117,209.65160359388966,334.97976430822405,336.34300107575405,218.8214479599926,2,13,12,10
118,188.63259378722455,307.66104089340797,308.66104089340797,230.39774678436243,3,11,11,8
119,188.63259378722455,307.66104089340797,308.66104089340797,230.39774678436243,3,11,11,8
120,207.19949574086826,348.26822505099835,349.8245519633783,254.74523150420794,3,11,11,8
121,207.19949574086826,348.26822505099835,349.8245519633783,254.74523150420794,3,11,11,8
