,OMA Sum rate,Architecture Sum rate,Baseline Sum rate,Fixed NOMA Sum rate,Fixed NOMA Pairs,NOMA Pairs,Baseline NOMA Pairs,Fixed NOMA Outage
0,209.76508490903836,384.0546689266024,384.3318390922569,345.2064227600339,6,18,18,12
1,278.58371738463586,457.5975290141764,462.0801864966751,278.58371738463586,0,17,17,17
2,313.0433850277599,456.8533740837831,472.7142312843367,328.9697919987144,3,13,17,14
3,265.1248937740208,448.0075956291656,450.9158721462195,320.93915661001364,3,16,15,12
4,241.7707896102386,450.81358467563905,452.5520924504028,298.7249642929064,4,17,18,14
5,314.01081422024015,512.6583050767747,517.0794499773167,373.89412382088517,3,14,14,11
6,280.90268900860104,456.3127623480956,457.2985236911358,331.0693642271943,3,15,14,11
7,274.5917902137015,442.76444792760395,453.89204387343574,393.0602551102753,6,16,17,11
8,249.17486582384697,423.25900506775235,429.7947885118165,433.03865515302687,10,17,18,8
9,294.8611000541241,422.55339466183966,423.4820282051604,327.0135535264121,2,13,14,12
10,295.708047919872,431.0330887710602,435.7887670152071,386.5874946803929,6,14,15,9
11,265.22914939362437,440.1270462668437,444.4526534731734,313.7483969507774,4,17,17,13
12,270.43985845941194,445.042231016483,445.95469453353525,333.6519010196906,3,16,16,13
13,265.68027472022374,382.1578981851138,382.1578981851138,351.63391427203345,3,13,13,10
14,258.97320108739376,458.0515559303393,459.0515559303393,363.56349577763,6,17,17,11
15,328.8849236192423,462.2897407910035,464.007327733349,405.1011560080131,3,13,13,10
16,294.95778312194864,469.7439702591292,472.23128518424215,330.57895128948644,1,16,17,16
17,339.1761656074291,483.8844039113585,484.7563885667936,409.49136764982273,3,13,13,10
18,291.93793037565257,486.5106966808461,490.9168775998496,390.40198693639945,5,16,16,11
19,233.27891507439955,437.2817963287593,456.2575889750248,426.9989896542232,10,18,19,9
20,314.4503685105168,489.25069401762215,494.11054747044795,399.9404297585536,3,15,15,12
21,256.79462637919994,442.0992411264079,443.2929773239273,404.92280393462136,7,16,15,8
22,240.85625584709197,464.1469273717845,466.5362788173076,290.5856311923073,4,17,16,12
23,302.31944450822533,474.00319560642015,482.6244752197962,345.11884775251315,4,16,17,13
24,329.5307362293329,487.45713878924863,488.9975132851139,351.2445032623605,2,14,13,11
25,317.06583504546086,464.41337480969145,467.51233474104095,320.2519432401809,1,13,13,12
26,276.8498133395277,472.23944861960024,481.4993393690205,359.1040581895561,5,15,16,11
27,261.6608894908637,436.94149977112943,440.5433419947916,300.0824971457265,5,16,16,11
28,298.8995102699499,453.64513639479287,453.64513639479287,440.3213065573816,7,12,12,5
29,265.23958462225823,446.85252504654227,450.6074571654872,402.1120046843455,5,15,15,10
30,284.60964404940495,436.78472112200944,445.26505171303404,491.3352181064628,8,16,16,8
31,223.22526882529667,470.328298756545,479.971787802628,258.52084598032485,3,20,20,17
32,194.84586587706318,431.1989528344146,436.97875796318874,304.56042286473524,10,20,20,10
33,290.99369608341726,446.873816235638,446.87381623563795,377.4367718090301,4,17,17,13
34,267.3952910187101,488.8200625774316,497.14793638822584,333.7156324046442,4,16,17,13
35,216.45499400287665,415.95164319685193,420.22557650428547,247.89117466022338,3,17,18,15
36,283.24340496038843,459.1075610767885,460.88185936736556,319.0025236617381,2,16,15,13
37,284.7924594234258,423.1853649992212,426.76443214081814,405.3378181958849,6,15,16,10
38,380.43207020324326,471.3599073089157,472.57425137897724,380.4320702032433,0,11,11,11
39,320.3846374552146,456.0410475889961,458.99523958167,320.2388428615874,1,14,14,13
40,239.93535719613612,418.56213415397593,424.0411092255052,284.97798497604606,4,18,19,15
41,273.6661217397327,448.39518969636765,454.0411282239007,440.9938486853132,7,16,14,7
42,276.97787850087013,468.2536346838817,476.17301814363327,355.5520625022734,4,15,15,11
43,219.348646364253,418.59863938123465,435.7200854113498,284.9859272604958,5,18,18,13
44,319.39800173503966,473.28290971550405,491.4198101208316,377.53510380013654,3,14,16,13
45,353.64201234763823,507.6265470250853,507.6265470250853,378.1537776466357,2,12,12,10
46,353.64201234763823,507.6265470250853,507.6265470250853,378.1537776466357,2,12,12,10
47,265.75096823645146,446.8956617781988,450.1739319908615,414.2558816799403,5,15,15,10
48,284.70718545952,446.8419128873072,455.3596591132894,357.3548691200221,6,17,17,11
49,284.70718545952,446.8419128873072,455.3596591132894,357.3548691200221,6,17,17,11
50,284.70718545952,446.8419128873072,455.3596591132894,357.3548691200221,6,17,17,11
51,284.70718545952,446.8419128873072,455.3596591132894,357.3548691200221,6,17,17,11
52,315.2281800985941,497.28795787115047,500.2679200600818,356.15795154091484,3,16,16,13
53,315.2281800985941,497.28795787115047,500.2679200600818,356.15795154091484,3,16,16,13
54,229.76310086185032,437.2226530411442,442.76236020732586,379.1430539606567,8,18,19,11
55,256.5820864459985,453.6609801123066,456.5058323303436,331.4029749089808,3,15,15,12
56,314.16831530047256,506.8483169800237,510.98110659033716,431.1959003475768,4,15,14,10
57,295.3849822663911,485.46506996569036,500.1108420953187,318.5838354562061,3,16,18,15
58,351.8561457174277,472.8544441183311,474.60104501165904,417.1648094903984,4,14,14,10
59,351.8561457174277,472.8544441183311,474.60104501165904,417.1648094903984,4,14,14,10
60,351.8561457174277,472.8544441183311,474.60104501165904,417.1648094903984,4,14,14,10
61,351.8561457174277,472.8544441183311,474.60104501165904,417.1648094903984,4,14,14,10
62,280.86700588017817,444.23019704374565,445.1971337360537,363.42460434199904,3,14,14,11
63,300.17571542353403,440.54105695402285,443.76639990268484,346.4342202829008,4,14,13,9
64,300.17571542353403,440.54105695402285,443.76639990268484,346.4342202829008,4,14,13,9
65,327.69110061966757,460.57940060278304,460.57940060278304,349.21210589073553,2,13,13,11
66,303.7752838290171,443.5745118287389,443.5745118287389,360.88007301072344,3,13,13,10
67,273.6895971739849,481.8281546973188,485.47057945128347,341.21243646361984,7,18,18,11
68,273.6895971739849,481.8281546973188,485.47057945128347,341.21243646361984,7,18,18,11
69,273.6895971739849,481.8281546973188,485.47057945128347,341.21243646361984,7,18,18,11
70,299.94849279922323,443.672760962251,451.6738083983721,342.90844074212885,3,12,14,11
71,266.7999519815233,455.809645321702,458.5034556851504,464.1262272595682,5,16,16,11
72,266.7999519815233,455.809645321702,458.5034556851504,464.1262272595682,5,16,16,11
73,266.7999519815233,455.809645321702,458.5034556851504,464.1262272595682,5,16,16,11
74,266.7999519815233,455.809645321702,458.5034556851504,464.1262272595682,5,16,16,11
75,292.8206663599274,463.3035730056332,472.58689734474444,394.1735398367808,4,14,15,11
76,272.2423572599989,463.9000416476687,469.00109114479756,308.03377132273033,3,16,16,13
77,272.2423572599989,463.9000416476687,469.00109114479756,308.03377132273033,3,16,16,13
78,231.13952135060129,443.3848885084298,452.990929509782,346.6598877024437,8,17,17,9
79,287.98913613803546,469.87205357961955,469.87205357961955,318.0783349984509,4,14,14,10
80,314.3879470923746,449.88180488529775,453.4915084251594,367.3289831268061,3,17,16,13
81,302.2444080022358,438.00884378023954,443.8535221510667,394.66829843412836,4,14,14,10
82,295.10583388933566,478.82628734645505,480.9146886448247,338.6624105710113,3,13,14,11
83,295.10583388933566,478.82628734645505,480.9146886448247,338.6624105710113,3,13,14,11
84,286.5372440399539,452.24737926062943,454.7464125103277,348.75486121242113,5,15,15,10
85,282.89339299066603,445.1556882006751,448.20871143703613,401.23489444635027,6,16,16,10
86,282.89339299066603,445.1556882006751,448.20871143703613,401.23489444635027,6,16,16,10
87,253.32078782665565,427.54229509380673,430.3760830919756,305.9362723256963,4,15,15,11
88,253.32078782665565,427.54229509380673,430.3760830919756,305.9362723256963,4,15,15,11
89,266.4152089870674,441.3726055884791,449.0115072844589,373.193186562822,4,17,17,13
90,266.4152089870674,441.3726055884791,449.0115072844589,373.193186562822,4,17,17,13
91,313.6691148414995,473.8202335013233,480.4287111755076,386.25605163126085,5,13,14,9
92,313.6691148414995,473.8202335013233,480.4287111755076,386.25605163126085,5,13,14,9
93,313.6691148414995,473.8202335013233,480.4287111755076,386.25605163126085,5,13,14,9
94,295.6133880914664,483.3523621841864,484.92492492241803,390.9367736513175,3,16,17,14
95,295.6133880914664,483.3523621841864,484.92492492241803,390.9367736513175,3,16,17,14
96,260.6970588950217,464.89154639601526,469.46562190963374,291.6635460613921,2,16,18,16
97,304.5479661077252,436.6859886341956,437.6859886341956,405.46595620802196,3,14,14,11
98,304.5479661077252,436.6859886341956,437.6859886341956,405.46595620802196,3,14,14,11
99,282.059210288348,387.9013866284175,387.9013866284175,426.51058994008,4,8,8,4
100,282.059210288348,387.9013866284175,387.9013866284175,426.51058994008,4,8,8,4
101,319.0352363337057,489.19953147569737,492.2871427284176,456.5295896606129,5,13,14,9
102,319.0352363337057,489.19953147569737,492.2871427284176,456.5295896606129,5,13,14,9
103,319.0352363337057,489.19953147569737,492.2871427284176,456.5295896606129,5,13,14,9
104,332.82067011221034,493.5154814343325,495.33090708381155,439.12000040983065,6,15,15,9
105,332.82067011221034,493.5154814343325,495.33090708381155,439.12000040983065,6,15,15,9
106,332.82067011221034,493.5154814343325,495.33090708381155,439.12000040983065,6,15,15,9
107,295.1966173903488,453.5041848502826,458.5184667989464,337.4327596087856,3,15,15,12
108,225.59067415614726,424.04296405771265,436.5055351053128,228.89532471070348,2,17,19,17
109,225.59067415614726,424.04296405771265,436.5055351053128,228.89532471070348,2,17,19,17
110,222.01721775467587,436.8342991008818,444.14238630475296,364.4890740417957,5,18,18,13
111,222.01721775467587,436.8342991008818,444.14238630475296,364.4890740417957,5,18,18,13
112,366.64505371071823,489.4101016289233,496.3895664251932,400.3390283816141,2,12,13,11
113,366.64505371071823,489.4101016289233,496.3895664251932,400.3390283816141,2,12,13,11
114,366.64505371071823,489.4101016289233,496.3895664251932,400.3390283816141,2,12,13,11
115,268.5136230344249,468.8407438498704,470.78159661455754,306.0856473004194,1,16,16,15
0,301.2169355210626,432.2473944875823,433.89961058097936,314.16419129301255,3,13,13,10
1,301.2169355210626,432.2473944875823,433.89961058097936,314.16419129301255,3,13,13,10
2,223.62119981414878,332.43926790187345,332.43926790187345,297.21422222715745,4,14,14,10
3,218.0743078145526,355.33552845914494,355.33552845914494,240.90258389305595,3,17,17,14
4,227.2675336880006,384.63845061477946,386.0814554062908,251.27278373048588,5,13,13,8
5,254.00820675620997,341.3809766314922,342.7003830905817,365.2371296706071,7,10,11,4
6,268.1216936293424,354.78511496758097,357.35576814042946,307.7502986207825,5,14,13,8
7,249.74910973319928,344.54455585198025,344.69687485166423,337.6853728950912,5,13,13,8
8,265.26622036465835,330.08819904247224,330.08819904247224,361.18244049004636,4,10,10,6
9,230.82379925453796,329.10778698902374,332.918692832168,387.07135993019045,7,14,14,7
10,230.82379925453796,329.10778698902374,332.918692832168,387.07135993019045,7,14,14,7
11,259.836664471204,358.57211009282264,359.3310032997121,370.60472837186455,4,15,15,11
12,289.686715993174,347.1539265223814,347.7953332981991,414.62764199458917,5,14,13,8
13,220.73881813851577,322.89635390388935,324.3086079486028,238.35136423920426,4,14,14,10
14,220.73881813851577,322.89635390388935,324.3086079486028,238.35136423920426,4,14,14,10
15,247.5714162269426,374.32413441708024,374.32413441708024,378.1786559090698,4,10,10,6
16,296.99682163972653,350.83937237084865,350.83937237084865,327.67025483060326,1,11,11,10
17,276.527845396688,386.6407441897772,386.6407441897772,309.7672684067697,1,11,11,10
18,208.33992328901002,367.17188184848976,370.40543722801175,323.0485532880173,6,17,16,10
19,208.33992328901002,367.17188184848976,370.40543722801175,323.0485532880173,6,17,16,10
20,211.52108839043623,361.8354950899288,371.3495456944702,240.00871913373766,5,16,18,13
21,211.52108839043623,361.8354950899288,371.3495456944702,240.00871913373766,5,16,18,13
22,308.1536315981594,401.4682539341704,401.4682539341704,308.1536315981594,0,10,10,10
23,230.69527933077995,407.4543123998658,409.69713480338214,282.7882664537168,6,17,17,11
24,230.69527933077995,407.4543123998658,409.69713480338214,282.7882664537168,6,17,17,11
25,266.43014354586285,400.3056501080886,400.3056501080886,305.15982290779044,3,14,14,11
26,266.43014354586285,400.3056501080886,400.3056501080886,305.15982290779044,3,14,14,11
27,229.1012374799273,364.05246661536455,366.15104046641386,284.5260775088808,5,15,15,10
28,216.17882000997267,379.35214545678645,380.74458583298065,281.4810686715918,6,15,16,10
29,236.59220214740628,364.0341747581949,364.57884311243487,244.70076495508908,3,15,16,13
30,271.8163674421983,380.8096869320426,380.8096869320426,271.389587291545,1,13,13,12
31,271.8163674421983,380.8096869320426,380.8096869320426,271.389587291545,1,13,13,12
32,256.7499939313823,381.13922285589376,381.13922285589376,352.66303101826975,5,12,12,7
33,236.2928495772215,349.82316504351684,349.82316504351684,349.31262756406716,6,14,14,8
34,236.2928495772215,349.82316504351684,349.82316504351684,349.31262756406716,6,14,14,8
35,320.4408195187946,454.73892071370847,455.9406467879164,349.43319180717685,2,14,13,11
36,320.4408195187946,454.73892071370847,455.9406467879164,349.43319180717685,2,14,13,11
37,224.218520793825,314.46060995268454,316.0966579738631,265.81369277509987,4,15,16,12
38,225.85776174881727,373.2892880397119,374.1459884112998,300.23485470971525,5,13,14,9
39,225.85776174881727,373.2892880397119,374.1459884112998,300.23485470971525,5,13,14,9
40,227.75293939396653,345.7820642182927,346.3937898489702,253.2047324515886,4,14,14,10
41,227.75293939396653,345.7820642182927,346.3937898489702,253.2047324515886,4,14,14,10
42,228.14423070068688,341.85317510339814,343.0461995357798,345.36459600533556,6,14,15,9
43,191.0942086161231,360.27004574686146,360.3441940648968,319.37804537268454,8,15,15,7
44,209.0262112331879,355.2822310860994,356.21888906966757,256.7270633184001,4,16,16,12
45,155.99117674003534,322.78705186744355,323.2048638491324,216.43983919007647,7,16,17,10
46,222.96105499946736,344.5364735240636,346.1390185627582,231.41043893179042,2,14,16,14
47,189.22832766293487,350.9093539225046,356.2092813163576,219.0253411601834,6,19,20,14
48,272.3924741597902,402.6330500995468,403.6330500995468,306.15424932974764,1,13,13,12
49,272.3924741597902,402.6330500995468,403.6330500995468,306.15424932974764,1,13,13,12
0,248.42528719931752,362.26359760639383,363.1056181658356,290.5086379824142,4,12,12,8
1,248.42528719931752,362.26359760639383,363.1056181658356,290.5086379824142,4,12,12,8
2,207.62280168710197,362.2661710772342,362.2661710772342,238.08581043125653,4,16,16,12
3,237.49408379637993,372.413673291852,373.3635349236456,277.21763627525553,3,15,15,12
4,205.86168456575658,337.58522610777004,337.58522610777004,294.04999398324577,6,15,15,9
5,291.40935800937405,405.34608753645034,405.34608753645034,336.2189009007969,2,11,11,9
6,221.63734310273145,390.8598216407489,391.1563439994061,284.03167491799366,6,17,17,11
7,219.2933668453408,344.45432046924964,345.45432046924964,267.60272716329973,4,15,15,11
8,206.01024152317586,352.96383572724494,352.96383572724494,224.47603644051657,4,14,14,10
9,237.08591662131252,379.91612654817595,383.16336329333,259.88455514116527,2,16,15,13
10,237.08591662131252,379.91612654817595,383.16336329333,259.88455514116527,2,16,15,13
11,199.3775128210621,348.41193112388345,350.6894125971771,211.0955612116247,5,16,17,12
12,298.91873412118713,386.2113602857273,386.2113602857273,369.43609639957344,2,12,12,10
13,185.0022697929603,344.0051519725468,344.0051519725468,197.20931662378268,2,17,17,15
14,185.0022697929603,344.0051519725468,344.0051519725468,197.20931662378268,2,17,17,15
15,236.32604375028077,381.0739110516463,381.0739110516463,329.2608611523394,6,12,12,6
0,243.84547501505406,378.26418396093356,378.2641839609335,248.50128095505818,3,14,14,11
1,243.84547501505406,378.26418396093356,378.2641839609335,248.50128095505818,3,14,14,11
2,303.6354786573565,426.7761615865256,431.3577622256581,344.9528171378345,4,14,14,10
3,272.0302757285009,405.2985941765977,405.2985941765977,359.3134215404071,2,14,14,12
4,209.79435667847522,442.3426140988413,452.80863295601597,291.86423886693876,5,18,18,13
5,251.7053407825002,426.9113744167022,429.8042385316812,273.52591857610156,2,17,18,16
6,291.0482343653431,413.1983044567305,413.1983044567305,361.41380918379764,4,12,12,8
7,279.7033538236225,455.0044085310244,461.9623504065703,357.86406169822953,7,14,15,8
8,265.37468741478904,431.1091899435984,431.24659087744556,347.53041023396946,2,13,14,12
9,321.72560353683525,447.3561983017008,447.35619830170083,380.1662421568822,3,12,12,9
10,321.72560353683525,447.3561983017008,447.35619830170083,380.1662421568822,3,12,12,9
11,279.70832677460686,455.10726719778387,455.10726719778387,340.2003884528974,4,14,14,10
12,325.377735614327,452.3113533906201,453.35458705513577,465.655963173716,6,12,13,7
13,298.50921391316183,450.92690522325944,456.5140894815637,402.6128243599276,4,15,16,12
14,298.50921391316183,450.92690522325944,456.5140894815637,402.6128243599276,4,15,16,12
15,226.66310144165197,396.73947224676306,402.57471117412865,285.9840389546014,5,16,16,11
16,226.66310144165197,396.73947224676306,402.57471117412865,285.9840389546014,5,16,16,11
17,269.6378808542844,425.43217009649953,436.9572414797151,364.38912074948405,5,15,16,11
18,269.6378808542844,425.43217009649953,436.9572414797151,364.38912074948405,5,15,16,11
19,228.6439737561394,448.17523455701905,449.5835276147712,276.8566462202458,5,18,18,13
20,298.37993510186163,463.91994564816093,463.91994564816093,382.81258556374985,5,14,14,9
0,298.37993510186163,463.91994564816093,463.91994564816093,382.81258556374985,5,14,14,9
1,298.37993510186163,463.91994564816093,463.91994564816093,382.81258556374985,5,14,14,9
2,305.91515003781325,423.5819807243081,423.5819807243081,368.97602090611315,2,13,13,11
3,259.7259399488974,436.690755422399,436.690755422399,273.5176224176487,2,16,16,14
4,266.8841954544589,415.8329836134236,415.8329836134236,353.60849414689574,3,13,13,10
5,231.41681948669623,403.9973356021874,404.76682416536136,258.7475232597038,2,14,13,11
6,305.07431851187573,438.0691046266485,438.38492158768395,358.6757820534315,3,13,13,10
7,275.0308882195806,428.61194477400863,428.61194477400863,309.474239244159,3,13,13,10
8,335.212786379712,411.1782523160993,411.1782523160993,335.212786379712,0,7,7,7
9,229.8999978534963,426.69883870795616,426.69883870795616,264.18990582607967,5,14,14,9
10,241.6695648073924,422.1758840973364,423.9267296388021,291.3134331631986,6,15,14,8
11,266.9468357497531,434.45328408434426,434.4617332537731,302.7069186331856,3,16,16,13
12,266.9468357497531,434.45328408434426,434.4617332537731,302.7069186331856,3,16,16,13
13,294.4798964944616,459.1028647413692,465.6887119558288,482.33384521234564,8,16,16,8
14,248.1847392670258,413.1048144775682,418.8634112360918,282.40513797641444,3,17,17,14
15,248.1847392670258,413.1048144775682,418.8634112360918,282.40513797641444,3,17,17,14
16,268.61379387673446,459.7495113227764,461.0058010951494,308.51170088091106,3,16,17,14
17,301.9885564906007,433.9964367262342,433.9964367262342,308.4342739956668,1,11,11,10
18,204.90001870288708,394.1346838950344,399.0376681372652,223.2086959884142,3,16,18,15
19,204.90001870288708,394.1346838950344,399.0376681372652,223.2086959884142,3,16,18,15
20,255.20529115768448,407.03932368652863,410.2078000743648,397.7317761529718,6,14,14,8
21,255.20529115768448,407.03932368652863,410.2078000743648,397.7317761529718,6,14,14,8
22,252.20605003594414,420.4049185056306,420.4049185056306,269.98409021197244,2,12,12,10
23,276.7556075167295,431.11508965424014,433.6080134457655,368.20425731527763,4,16,16,12
0,258.6769507855398,394.6556090923243,397.3831493085539,296.722880420535,4,15,14,10
1,258.00918179886173,443.1876744968355,443.1876744968355,294.7894877698662,2,15,15,13
2,233.36994212685278,431.2290763744961,434.4910207937209,354.11843611039757,6,17,17,11
3,287.8988273342794,461.86502852335946,462.86502852335946,422.8839236712703,5,15,15,10
4,295.073991668486,483.9918174592848,483.9918174592848,369.86124299664556,6,16,16,10
5,266.01535984845634,454.98270523420376,461.5339338252828,292.90967583254724,3,16,19,16
6,266.01535984845634,454.98270523420376,461.5339338252828,292.90967583254724,3,16,19,16
7,266.01535984845634,454.98270523420376,461.5339338252828,292.90967583254724,3,16,19,16
8,248.76477833809741,411.3553963534669,411.36005257257085,344.39180821855666,5,15,14,9
9,248.76477833809741,411.3553963534669,411.36005257257085,344.39180821855666,5,15,14,9
10,233.40219834004117,394.1771679433176,396.4402600210933,278.8328794043117,4,19,17,13
11,241.98814224475547,433.415605302051,436.7429028256057,295.9559085127107,5,18,17,12
12,198.79331541588343,408.41326923728866,424.38850663122093,287.78408947090105,7,19,20,13
13,198.79331541588343,408.41326923728866,424.38850663122093,287.78408947090105,7,19,20,13
14,198.79331541588343,408.41326923728866,424.38850663122093,287.78408947090105,7,19,20,13
15,250.95089732827466,443.8292815435282,448.2999039979558,311.3701623696834,6,17,16,10
16,339.3672682827317,455.3678861184503,455.7856657958598,402.1786823802335,4,13,12,8
17,339.3672682827317,455.3678861184503,455.7856657958598,402.1786823802335,4,13,12,8
18,272.56667524905515,468.23420519984217,471.70738260657095,360.89486561851425,5,14,15,10
19,215.67759715387004,445.6502917387542,445.6502917387542,365.7439796257192,9,16,16,7
20,251.38989976494395,400.77543204674157,400.77543204674157,279.63273374886995,5,14,14,9
0,247.8419347291882,361.4659891185246,362.61043600254743,299.31815959239884,1,14,14,13
1,247.8419347291882,361.4659891185246,362.61043600254743,299.31815959239884,1,14,14,13
2,241.5353728690066,387.92310276849105,387.92310276849105,247.8744150911634,3,13,13,10
3,299.9250399219776,450.2726691868276,450.8472211560645,374.5461023243889,5,12,12,7
4,224.01727850445616,442.378674527356,444.94075240883444,277.4054001471713,2,16,18,16
5,253.76229466091797,438.79240649918097,446.57642341324146,351.8944758565877,8,15,15,7
6,253.76229466091797,438.79240649918097,446.57642341324146,351.8944758565877,8,15,15,7
7,275.95041920870585,436.21082608120605,437.08024888028683,292.95107623537,3,16,15,12
8,229.17535664396965,407.94541233275004,408.1391856398171,333.0053752519118,5,16,17,12
9,229.17535664396965,407.94541233275004,408.1391856398171,333.0053752519118,5,16,17,12
10,229.17535664396965,407.94541233275004,408.1391856398171,333.0053752519118,5,16,17,12
11,223.25288473474905,401.36603473633016,401.7087489252555,242.18270457888266,2,16,16,14
12,277.3982874305792,445.0992748315533,445.09927483155326,313.05055580744806,4,12,12,8
13,224.1453547876353,400.6211631589889,400.9532332926814,250.96336600647268,4,19,19,15
14,224.1453547876353,400.6211631589889,400.9532332926814,250.96336600647268,4,19,19,15
15,224.1453547876353,400.6211631589889,400.9532332926814,250.96336600647268,4,19,19,15
16,324.6909150158943,439.98603145763116,439.98603145763116,343.35666468351013,4,10,10,6
17,264.94909577036043,428.90255987605974,428.90255987605974,351.8352066816454,4,15,15,11
18,256.0916604809433,438.1419078844209,438.1419078844209,315.93520590907065,4,15,15,11
19,256.0916604809433,438.1419078844209,438.1419078844209,315.93520590907065,4,15,15,11
20,222.24001521314656,414.25933394874653,414.32775039751425,347.73879514766537,8,16,15,7
21,245.62758049505527,439.163062199008,441.2732223320669,329.55335321060807,4,15,15,11
22,224.7605706426801,401.830307650508,410.2713344356047,270.2087627065047,2,18,18,16
23,251.59125539843893,410.16147316480897,410.16147316480897,262.2476747331839,2,16,16,14
24,226.02515671053075,397.7517905087897,400.0591556730495,294.5360275581733,4,17,17,13
25,244.51350988803267,370.0692846329445,370.0692846329445,331.3459942311888,4,13,13,9
26,301.72419737373303,444.30714852658286,444.9423733631014,322.2761870888703,2,13,12,10
27,236.9722921412383,358.6010539096123,358.6010539096123,282.72319237041967,2,12,12,10
28,317.4929174620506,416.9349591787883,416.9349591787883,317.4929174620507,0,10,10,10
29,317.4929174620506,416.9349591787883,416.9349591787883,317.4929174620507,0,10,10,10
30,231.8313595112886,419.8863128871048,419.88631288710474,311.19084356289625,4,17,17,13
31,218.55373227804904,422.78528459799816,424.8295223210728,331.5782352554522,7,16,17,10
32,196.6277740974555,384.44242750521937,384.44242750521937,304.6825251469729,6,15,15,9
33,242.16378249574257,412.5379439370864,414.64394083828057,342.29667953308604,6,14,13,7
34,216.46985635838672,364.2097172844635,365.08646201755437,294.14452743445077,8,14,14,6
35,287.31533668083205,390.0498133261442,390.0498133261442,392.58374392415743,4,11,11,7
36,262.9827262733463,391.21527805644627,392.2379151135874,318.6485678613067,3,13,13,10
37,262.9827262733463,391.21527805644627,392.2379151135874,318.6485678613067,3,13,13,10
38,218.32278677927883,406.5531031307073,406.5531031307073,324.20110653460927,7,13,13,6
39,235.01775545825546,417.10295036385685,417.43280485952374,302.3243119117648,5,18,18,13
40,222.02054574570508,419.6494648934017,423.1918876425239,257.1755088073661,4,18,18,14
41,240.07310699926788,405.7331182329176,405.7331182329176,326.17628238065134,8,14,14,6
42,240.07310699926788,405.7331182329176,405.7331182329176,326.17628238065134,8,14,14,6
43,213.2742648042843,394.3563677517555,394.3563677517555,296.9247388286423,5,13,13,8
44,213.2742648042843,394.3563677517555,394.3563677517555,296.9247388286423,5,13,13,8
45,226.90920127260944,377.3857074811022,377.3857074811022,226.72651900952854,3,11,11,8
46,254.2910980752749,403.2914268811911,404.58601433593833,321.59376000463214,3,17,17,14
47,254.2910980752749,403.2914268811911,404.58601433593833,321.59376000463214,3,17,17,14
48,248.02534902405915,418.9774289496491,420.7655610583285,272.5207686495743,4,16,16,12
49,248.02534902405915,418.9774289496491,420.7655610583285,272.5207686495743,4,16,16,12
50,223.45435766185088,406.99339510274547,407.26386172081584,270.6324264535802,4,15,14,10
51,223.45435766185088,406.99339510274547,407.26386172081584,270.6324264535802,4,15,14,10
0,237.14209806026884,403.31777446388014,403.31777446388014,287.92251489453616,3,17,17,14
1,275.520293623538,422.98008992536353,423.4791393114078,286.75884227695053,3,14,14,11
2,205.38971004462618,392.58444846156897,394.61020441960807,291.13746364060927,4,17,17,13
3,205.38971004462618,392.58444846156897,394.61020441960807,291.13746364060927,4,17,17,13
4,324.8644564561413,422.3081807493869,422.4187494458534,334.03351731458537,1,12,13,12
5,324.8644564561413,422.3081807493869,422.4187494458534,334.03351731458537,1,12,13,12
6,216.55184123095142,398.48084300702664,404.7159835613153,341.2717627233919,6,16,17,11
7,216.55184123095142,398.48084300702664,404.7159835613153,341.2717627233919,6,16,17,11
8,229.8079121230403,404.00059869802425,410.69057490360115,296.92554850111554,7,16,17,10
9,234.1311850406351,408.47376139980537,408.47376139980537,313.7477992113987,6,15,15,9
10,234.1311850406351,408.47376139980537,408.47376139980537,313.7477992113987,6,15,15,9
11,253.0911513581171,420.87675483970327,420.87675483970327,279.44416612532893,2,16,16,14
12,281.8748403792973,441.4444949721053,442.3908509895211,287.9026668076382,1,14,13,12
13,260.3453494813337,423.1942767808203,423.32972246599843,266.37317590967456,1,13,14,13
14,260.3453494813337,423.1942767808203,423.32972246599843,266.37317590967456,1,13,14,13
15,224.8858204857696,397.3581525466796,399.5157732416598,259.1353510503742,4,15,15,11
16,224.8858204857696,397.3581525466796,399.5157732416598,259.1353510503742,4,15,15,11
17,241.11912976367313,403.74078399587637,404.1756633029639,288.2825802189172,4,14,14,10
18,276.4005158210097,423.50594361761165,430.16931188560307,333.3171941065373,4,16,16,12
19,251.77917540739003,385.2079641679219,385.20796416792183,261.5674023327111,2,14,14,12
20,251.7353732610614,337.64713817072936,337.6471381707293,314.5701390504465,3,9,9,6
21,333.9122989917833,421.1260451036343,423.4114993745157,374.86833891115515,2,13,14,12
22,246.29287289380716,419.78786402746726,419.78786402746726,278.9213755356199,3,15,15,12
23,215.67702661030492,402.5345237600759,407.4142754049178,267.2538641338281,6,18,19,13
24,250.5746737977252,409.7699947246697,410.3097743249001,347.25453411680013,4,15,16,12
25,238.52374170760282,405.6807209017022,409.58018819429924,316.86882126343914,6,15,15,9
26,258.8551139599264,432.0358594498075,435.9974273271077,342.397326715196,5,16,17,12
27,228.63676588706554,396.45969451203337,396.45969451203337,262.5590761877177,1,14,14,13
28,236.35502217583954,434.8547826211684,440.3842631425692,246.69658512831174,3,17,19,16
29,257.1167920378752,420.0058052293006,420.0058052293006,312.9035701048669,5,13,13,8
30,229.55225968046727,367.34413982615365,369.5361389489532,285.28101182391435,4,16,16,12
31,265.6196450376983,403.8874650657384,406.8431811835902,356.6147826342523,5,13,14,9
32,263.52852821360096,426.3229126407289,426.3229126407289,365.02921346293283,5,14,14,9
33,263.52852821360096,426.3229126407289,426.3229126407289,365.02921346293283,5,14,14,9
34,196.3921429739766,394.4054440373151,395.66901467252296,236.6176307534298,4,18,18,14
35,218.0645666543364,391.13823694186544,392.26029202266733,291.5738086231259,4,14,14,10
36,238.41357693218788,410.3799098806667,412.152627616972,289.4455218977912,3,16,15,12
37,238.41357693218788,410.3799098806667,412.152627616972,289.4455218977912,3,16,15,12
38,327.8410984371892,447.7711100721565,447.7711100721565,365.9721606503424,5,11,11,6
39,254.61959715213962,374.38634096306953,374.38634096306953,322.01909740507205,5,14,14,9
40,291.97800870736313,414.7160790964681,414.7160790964681,354.0329413022338,4,12,12,8
0,293.43836123573,482.7381543985058,484.22502186976203,338.07104630635126,1,16,16,15
1,301.3080974365619,492.0604946317057,494.6800705689272,326.09956575478355,2,17,17,15
2,223.84600083047258,375.5007022356267,375.5007022356267,299.3040863211058,4,15,15,11
3,225.79531618211757,388.4220470239652,388.4220470239652,330.90367059858846,4,13,13,9
4,289.59592052815725,447.9944320581171,447.9944320581171,289.5959205281573,0,13,13,13
5,252.09126774390188,418.8120536712557,418.8120536712557,294.8953183729603,3,15,15,12
6,273.54221578854015,436.2657776540904,444.14907869100625,368.6475697121243,6,16,18,12
0,278.1358308733518,462.37263771760354,463.65920159109874,337.09644986664324,2,15,15,13
1,268.72423702028976,388.0812471227981,389.3194333303827,274.01204540417143,1,11,11,10
2,313.25479611307037,458.14011184921907,458.4653464886324,359.13603567443494,2,12,12,10
3,284.0396713471636,427.1050601489837,427.244976474889,322.66905181532724,3,14,14,11
4,278.4311076590754,436.00950625687994,441.73421624141815,309.7598436336507,6,15,15,9
5,280.9390993714459,425.4580704315387,427.0765120111397,423.2375910399778,7,15,15,8
6,279.25241431023926,438.0456355622582,438.0456355622582,381.60591319365517,4,13,13,9
7,273.85512649331656,453.85550669605675,461.6756122306428,317.20552162864425,4,15,16,12
8,258.1313561300323,438.6400812981859,312.4895043204373,347.8746588083789,4,14,22,18
0,258.1313561300323,438.6400812981859,443.0244374033243,313.3377276390174,6,14,14,8
1,258.1313561300323,438.6400812981859,443.0244374033243,313.3377276390174,6,14,14,8
2,258.1313561300323,438.6400812981859,443.0244374033243,313.3377276390174,6,14,14,8
3,259.3357869309624,421.41499384420877,422.08317692255685,295.9626306487935,4,15,16,12
4,332.47426392693603,449.41455233915235,449.426028908187,385.0573093406091,3,12,13,10
5,232.9158274576486,423.82212753696564,428.43286111538885,324.37151304550775,7,16,17,10
6,232.9158274576486,423.82212753696564,428.43286111538885,324.37151304550775,7,16,17,10
7,283.6543973777823,444.7105445205035,449.9292887918092,396.5325346698685,5,14,14,9
8,230.2885532522743,431.1799576493915,440.80211272633176,256.7074666383978,4,18,18,14
9,304.3443772067093,453.2164067467213,456.29389316534525,368.71628727970824,3,15,14,11
10,262.8303158595231,422.60659232871274,434.61006534874366,360.501061961749,4,15,17,13
11,262.8303158595231,422.60659232871274,434.61006534874366,360.501061961749,4,15,17,13
0,263.2011072344793,441.7800482173826,444.54264931298985,337.1496345075311,5,17,16,11
1,276.34213612785027,431.83866788617524,431.83866788617524,422.44522281291546,6,13,13,7
2,247.46171376468294,436.29455386329914,440.0772237278022,273.74271236245386,3,17,16,13
3,256.29071084749626,400.88797116532197,403.42914675489646,302.70719850116706,4,15,14,10
4,215.99858146818949,408.76829611785047,408.76829611785047,262.7495076735019,3,15,15,12
5,245.93490036364645,385.5885383475243,386.60320163973694,299.53383122293667,3,14,13,10
6,179.68076463455512,413.10770648208063,414.37562961787444,274.45947656341707,7,20,19,12
7,213.68597171827653,423.60392852833127,423.60392852833127,233.61660746987062,4,14,14,10
8,249.37970742290642,464.1254668431964,464.1254668431964,311.18036349793715,8,16,16,8
9,252.71342015411454,406.9410817234136,406.9410817234136,319.78006691040974,4,14,14,10
10,252.71342015411454,406.9410817234136,406.9410817234136,319.78006691040974,4,14,14,10
11,246.84395653016693,444.7858912709441,445.0310678092934,361.43369900623213,6,16,16,10
12,294.07352741193756,446.64615725907686,448.13920554321805,323.8894688073177,3,14,14,11
13,248.36297540527409,429.46801695563613,429.46801695563613,278.8168663457066,1,14,14,13
14,269.7974666716139,435.53239143880126,435.53239143880126,323.84312908356554,4,14,14,10
15,269.7974666716139,435.53239143880126,435.53239143880126,323.84312908356554,4,14,14,10
16,231.59159908362193,353.17318460812373,353.17318460812373,416.650548869549,8,16,16,8
17,231.59159908362193,353.17318460812373,353.17318460812373,416.650548869549,8,16,16,8
18,251.64009920859863,380.00587508585363,380.00587508585363,299.676002673203,3,15,15,12
19,251.64009920859863,380.00587508585363,380.00587508585363,299.676002673203,3,15,15,12
20,228.6777963231959,360.56830324241844,360.56830324241844,230.5888183548836,1,15,15,14
21,233.4580854044302,379.41162026638773,379.41162026638773,264.6688239739873,3,14,14,11
22,252.30881257802102,425.4954400333012,426.1627204498882,342.5045104957233,4,12,12,8
23,189.3958278511993,410.83138977632063,415.2489050962381,226.17850506723,4,18,17,13
24,271.0837110206676,405.13264955774287,406.1825711075858,373.343527289452,4,16,16,12
25,273.2424882419185,422.5157401899797,422.6082017508406,304.2261256462805,1,12,12,11
26,252.0953213826655,424.7814259939135,424.7814259939135,336.0715857706569,5,14,14,9
27,204.16537580299632,434.5355061154813,437.0350990573038,316.84004282111493,8,17,17,9
28,224.9567712816607,433.3415902545217,434.67217262421644,284.6470833826282,5,18,17,12
29,226.09174742520037,435.68636847939104,438.14002871376067,300.12420965251073,5,18,18,13
30,226.09174742520037,435.68636847939104,438.14002871376067,300.12420965251073,5,18,18,13
0,226.09174742520037,435.68636847939104,438.14002871376067,300.12420965251073,5,18,18,13
1,325.18936748902195,543.9759607205986,547.4029790183766,401.4519883293847,5,17,17,12
2,284.06378561801864,454.3919574571203,454.52141635903547,328.6973018474013,2,14,15,13
3,238.1433146344174,451.81022876188865,453.15897544402884,292.2310416485241,4,18,17,13
4,218.63757485309847,436.03200198004083,436.03200198004095,254.0206896531473,4,18,18,14
5,261.7086059469476,470.4548597723507,470.4548597723507,276.35627761328186,2,12,12,10
6,304.0142960191493,499.5060862117625,499.5060862117625,329.05902566093357,4,13,13,9
7,274.5300941277617,481.27813594546456,484.1170875997725,419.25247096791,8,15,14,6
8,274.5300941277617,481.27813594546456,484.1170875997725,419.25247096791,8,15,14,6
9,301.44802237182745,467.37387962581136,467.37387962581136,363.487571666906,5,13,13,8
10,293.79768154585264,480.64730482728066,483.4042849053111,365.5810411939674,4,13,14,10
11,293.79768154585264,480.64730482728066,483.4042849053111,365.5810411939674,4,13,14,10
12,262.36572909732945,447.24197126842836,448.00156745156414,315.23137823350464,5,16,16,11
13,245.06679749255972,491.5218586451581,493.582552685106,323.6965524312587,5,17,16,11
14,283.8864104251288,450.70821006129364,452.53091983531,327.8511216048355,4,14,15,11
15,350.2198764500264,503.52979410963485,503.52979410963485,350.21987645002633,0,10,10,10
16,272.24335202098297,503.3463156625746,508.21264025729283,350.28600470631824,2,17,17,15
17,278.55291692722744,459.46820209158864,462.2769518064922,371.09445703212174,3,16,15,12
18,315.54742841361855,493.2477216813519,493.24772168135183,354.0125532268308,2,13,13,11
19,315.54742841361855,493.2477216813519,493.24772168135183,354.0125532268308,2,13,13,11
0,315.54742841361855,493.2477216813519,493.24772168135183,354.0125532268308,2,13,13,11
1,322.9158697882653,511.5661084447784,515.7233573526046,439.41702211905084,6,16,16,10
2,288.79122084630336,500.21738027764815,517.5021704810943,356.8046783959333,5,16,16,11
3,209.78947307744477,462.1676945762341,466.26677958429724,330.4786167819709,4,19,19,15
4,296.48858819327216,511.5334544298701,515.8436298241099,340.03203031488994,2,18,18,16
5,296.48858819327216,511.5334544298701,515.8436298241099,340.03203031488994,2,18,18,16
6,299.34475388136707,493.59805926992965,499.5078900813177,357.9428759756947,3,16,17,14
7,298.9540984868729,506.4210847505493,511.5524730276411,327.5080038443913,2,16,16,14
8,253.16697544666087,452.1930970780334,469.90532603941375,315.45932527083784,6,18,19,13
9,253.4943487317902,479.4200920232637,490.2420486709383,440.9775526398493,8,17,17,9
10,253.4943487317902,479.4200920232637,490.2420486709383,440.9775526398493,8,17,17,9
11,290.40449704075263,437.1806986820158,440.11562186965125,419.6139058261698,5,14,13,8
12,351.146638035719,483.6292084993197,485.61094722247424,442.7427728825575,4,13,14,10
13,263.45966745031706,452.37539205769156,454.27249368103764,315.84284615011495,3,13,13,10
14,263.45966745031706,452.37539205769156,454.27249368103764,315.84284615011495,3,13,13,10
15,365.63689557660183,548.4314662568697,548.8401167983875,375.60764159267296,1,14,14,13
16,306.6526812376158,495.79259452725546,495.79259452725546,436.41581394237556,5,15,15,10
17,266.822442859695,455.1589734314476,456.90033252528974,295.2507205694887,3,14,14,11
18,266.822442859695,455.1589734314476,456.90033252528974,295.2507205694887,3,14,14,11
19,323.34474991859594,446.8617823557463,447.0594989410648,323.3447499185959,0,12,12,12
0,323.34474991859594,446.8617823557463,447.0594989410648,323.3447499185959,0,12,12,12
1,242.73481282703264,409.0226994654768,409.0226994654768,303.1309598563611,4,15,15,11
2,250.3464292716265,383.5585118020018,383.5585118020018,318.8716200786221,4,12,12,8
3,200.8500636137991,401.0025783809758,410.09114592556796,358.6075094423409,8,18,18,10
4,273.1154555472412,433.3602833703087,434.41291896217285,299.81634824226734,4,16,16,12
5,328.12540330519323,495.38672288239275,496.6071382679554,360.57133516971624,3,14,15,12
6,243.47727170380332,439.806914582387,442.4025620120393,322.78659336197785,7,17,17,10
7,243.47727170380332,439.806914582387,442.4025620120393,322.78659336197785,7,17,17,10
8,216.3035900092877,441.8351502048589,444.0872413116201,291.33242768718384,7,18,19,12
9,335.37422057893014,475.2386688514997,475.2386688514997,401.7013364920069,4,11,11,7
10,335.37422057893014,475.2386688514997,475.2386688514997,401.7013364920069,4,11,11,7
11,261.8310312511297,424.7745905799801,425.7745905799801,321.25275810783455,3,14,14,11
12,285.2193239326307,400.0917138479746,400.0917138479745,336.6415385404624,3,9,9,6
13,235.91062198153438,432.0789436833419,433.36278971850703,303.0944879256607,6,15,15,9
14,250.19435956113827,373.51405967583935,373.51405967583935,332.3868576629675,4,13,13,9
15,227.2561199535437,445.55144901695087,446.144293477452,234.25398118317312,3,17,16,13
16,227.2561199535437,445.55144901695087,446.144293477452,234.25398118317312,3,17,16,13
17,258.39746570509647,445.8545868917781,447.6940654622262,287.0249921337028,4,17,17,13
18,289.20713983551605,413.9875054016234,413.9875054016234,292.3728404216355,2,11,11,9
19,307.54602540808236,441.0886626820096,441.0886626820096,307.3165959474274,3,11,11,8
20,304.1217289348204,445.8467779558944,446.90374744103013,416.86228274075506,4,14,14,10
21,286.48755680197314,451.64384022450815,453.7884182966128,383.9356819121882,6,14,15,9
22,305.8894964901508,448.6173171773264,448.95045973851273,310.919353960918,3,15,14,11
23,207.46211956275022,422.0792823821845,424.935564385009,302.04978273581025,6,18,16,10
24,281.5141605153402,465.4450321494474,465.4450321494474,362.5675108804282,6,15,15,9
25,279.3102272391351,434.42254203271443,434.42254203271443,309.53135620027354,2,13,13,11
26,248.82994262067396,432.75379056398,437.82410742499496,286.50962641634317,5,17,17,12
27,213.59684074838356,376.03995667389495,376.03995667389495,311.0107287655157,5,12,12,7
28,213.59684074838356,376.03995667389495,376.03995667389495,311.0107287655157,5,12,12,7
29,341.7523944947081,472.34323501993345,472.56341102083513,372.3726641028938,1,11,11,10
0,232.82851299492157,415.7715189287659,416.99795204793315,271.03708044942886,3,15,16,13
1,238.2925122369323,410.9574261137467,421.37811993276057,325.7052893561258,3,14,15,12
2,250.40014240071454,448.7399753223672,464.799928590263,311.1431788436349,4,18,19,15
3,296.85652806872315,469.1085639283907,479.8767975428724,431.3101261937012,7,16,18,11
4,256.41692756411527,467.2574737001028,467.2574737001028,351.71994830241727,6,16,16,10
5,246.10693875937716,444.8244338345389,447.358023133104,277.0515972754938,1,18,18,17
6,318.392803710821,482.71714030026305,487.47682108607233,338.50515448447777,2,15,15,13
7,283.2649574102096,479.1416655402463,479.8968543200441,322.83277688499436,3,17,18,15
8,268.3520118424302,435.16481501750394,436.3609934365464,330.16323604161175,4,15,16,12
9,268.3520118424302,435.16481501750394,436.3609934365464,330.16323604161175,4,15,16,12
10,264.5934735878488,468.0094381536508,471.4202557229692,264.5934735878487,0,17,17,17
11,272.2032270124877,460.9841261375476,460.9841261375476,329.57708936181933,2,16,16,14
12,322.6281422042312,504.58177527983565,505.58177527983565,418.9383672620845,4,16,16,12
13,322.6281422042312,504.58177527983565,505.58177527983565,418.9383672620845,4,16,16,12
14,287.10124075432464,427.5087897721596,429.6150777922545,345.77379856801895,5,14,14,9
15,243.68000148158416,426.09716644403227,429.1564460109904,349.256150952599,6,17,18,12
16,243.68000148158416,426.09716644403227,429.1564460109904,349.256150952599,6,17,18,12
17,263.28901113382216,482.19895792652824,487.4202176092925,292.0587142260489,3,16,17,14
18,345.1113824175759,477.22389513622767,477.22389513622767,421.26604259316576,4,14,14,10
19,277.31977807149633,445.1157876926517,446.5720238243483,338.87156705521994,7,15,15,8
20,236.30816264465327,463.35179989194165,467.9122866765659,297.00865431504116,4,17,18,14
21,258.25531568225597,429.40581710394815,433.6030021788371,310.8061495961846,6,14,15,9
22,291.42712537964564,492.80163216629865,494.19820091466727,334.29777593336627,5,16,17,12
23,270.13740926088326,456.76230086047815,463.42608413305334,368.0938997515291,7,15,16,9
24,284.3023130856875,450.651226039412,452.0749267666654,314.35165851874854,1,15,16,15
25,267.2864579008005,401.0769459640322,401.0769459640322,287.8357813562251,3,14,14,11
26,281.2774972116063,469.8600808792402,472.8953487739898,330.9266219816122,3,17,16,13
27,233.90311255629803,457.21323941829144,462.30594983519137,293.0214063640069,5,16,17,12
28,268.0317973074959,490.46581554510954,494.9512143235734,370.5990308422487,4,17,17,13
29,317.97193981702793,455.2033134933893,455.2033134933893,356.4735620627423,3,13,13,10
